11111111111111111111111
1P000000000010010000001
100111100100100111C1111
10010000010000000000011
11110010011111111110011
1000001000001C00E000001
11110011110011111111111
10000010000000000001001
11111111111111111111111
