1111111111111111111111111
1P00000000001001000000001
100111100100100111C111001
1001000001000000000001001
1111001001111111111001001
1000001000001C00000000001
11110011110S1111111111001
1000001000000000000100001
1001111001111111111110111
10010000000010000010000C1
1011001001001111001110111
10C10010010C1000001E00001
1111111111111111111111111
